15 15
###############
#@............#
#.###.#######.#
#...#.......#.#
###.#.#####.#.#
#T..#.#...#.#.#
#.###.#.#.#.#.#
#.....#.#...#.#
#####.#.###.#.#
#...#.#.#T#.#.#
#.#.#.#.#.#.#.#
#.#...#...#...#
#.#########.#.#
#.........TI#T#
###########T###