10 30
@............1#1.............T
..............#..........II...
.......T......#...............
............I4#2.............C
##############################
.............4#2.............I
..............#...............
..............#...............
......I.......#...............
TC...........3#3......I......T