7 7 3
###@###
#.....#
#..#..#
E..#..E
#..#..#
#.....#
###E###