7 7
###@###
#.....#
#..#..#
T..#..T
#..#..#
#..I..#
###T###