15 15 5
###############
#@............#
#.###.#######.#
#...#.......#.#
###.#.#####.#.#
#E..#.#...#.#.#
#.###.#.#.#.#.#
#.....#.#...#.#
#####.#.###.#.#
#...#.#.#E#.#.#
#.#.#.#.#.#.#.#
#.#...#...#...#
#.#########.#.#
#.........E.#E#
###########E###