10 24
@.........1#1..........T
...........#.......II...
....T......#............
.........I4#2...........
########################
..........4#2..........I
...........#............
...........#............
....I......#............
T.........3#3...I......T