13 22
######################
#@........##........T#
#.######..##..######.#
#.#....#..I...#....#.#
#.#.T#.#..1...#.#T.#.#
#.#..#.########.#..#.#
#....#..........#....#
#.#..#.########.#..#.#
#.#I.#.#..1...#.#.I#.#
#.#....#......#....#.#
#.######..##..######.#
#T........##........T#
######################